11111111111111111111
11000011111000001111
11011011000011101101
11011000011011100001
00011111100011111111
11011000001111111111
11011011111111000000
10011011000111111011
10111011010111000011
10001011010111011111
10101000010111011111
10101101110000011111
10100001111110111111
11111111111111111111